9,9,9,9,6,6,6,6,6,6,9,9,9,2,2,2,2,2,2,2,2,2,2,2,2,2,10,11,2,2,2,10,11,2,2,2,2,2,2,9
9,9,9,9,6,6,6,6,6,9,9,9,9,2,2,2,2,2,2,2,2,2,2,2,2,2,13,12,2,2,2,13,12,2,2,2,2,2,2,9
9,9,9,9,6,6,6,6,6,9,9,9,9,2,2,2,2,2,2,2,2,2,2,2,2,2,2,2,2,2,2,2,2,2,2,2,2,2,2,9
9,9,9,9,6,6,6,6,6,9,9,9,9,2,2,2,2,2,2,2,2,2,2,2,2,2,2,2,2,2,2,2,2,2,2,2,2,2,2,9
9,9,9,9,6,6,6,6,6,9,9,9,9,2,2,2,2,2,2,2,2,2,7,7,7,7,7,7,7,7,7,7,2,2,2,2,2,2,2,9
9,9,9,9,9,9,9,9,9,9,9,9,9,2,2,2,2,2,2,2,2,2,7,7,7,7,7,7,7,7,7,7,2,2,2,2,2,2,2,9
1,9,9,9,9,9,9,9,9,9,9,9,9,2,2,2,2,2,2,2,2,2,7,7,7,7,7,7,7,7,7,7,2,2,2,2,2,2,2,9
1,9,9,9,9,9,9,9,9,9,9,9,9,2,2,2,2,2,2,2,2,2,7,7,7,7,7,7,7,7,7,7,2,2,2,2,2,2,2,9
1,1,9,9,9,9,9,9,9,9,9,9,9,2,2,2,2,2,2,2,2,2,7,7,7,7,7,7,7,7,7,7,2,2,2,2,2,2,2,9
1,1,9,9,9,9,9,9,9,9,9,9,9,2,2,2,2,2,2,2,2,2,2,2,2,2,2,2,2,2,2,2,2,2,2,2,2,2,2,9
1,1,9,9,9,9,9,9,9,9,9,9,9,2,2,2,2,2,2,2,2,2,2,2,2,2,2,2,2,2,2,2,2,2,2,2,2,2,2,9
1,1,9,9,9,9,9,9,9,9,9,9,9,2,2,2,2,2,2,2,2,2,2,2,2,2,2,2,2,2,2,2,2,2,2,2,2,2,2,9
1,1,9,9,9,9,9,9,9,9,9,9,9,2,2,2,2,10,11,2,2,2,2,2,2,2,2,2,2,2,2,2,2,2,10,11,2,2,2,9
1,1,9,9,9,9,9,9,9,9,9,9,9,2,2,2,2,13,12,2,2,2,2,2,2,2,2,2,2,2,2,2,2,2,13,12,2,2,2,9
1,1,9,9,9,9,9,9,9,9,9,9,9,9,9,9,9,9,9,9,9,9,9,9,9,9,9,9,9,9,9,9,9,9,9,9,9,9,9,9
1,1,9,9,9,9,9,9,9,9,9,9,9,9,9,9,9,9,9,9,9,9,9,9,9,9,9,9,9,9,9,9,9,9,9,9,9,9,9,9
1,1,9,9,9,9,9,9,9,9,9,9,9,9,9,9,9,9,9,9,9,9,9,9,9,9,9,9,9,9,9,9,9,9,9,9,9,9,9,9
1,1,9,9,9,9,9,9,9,9,9,9,9,9,9,9,9,9,9,9,9,9,9,9,9,9,9,9,9,9,9,9,9,9,9,9,9,9,9,9
1,1,9,9,9,9,9,9,9,9,9,9,9,9,9,9,9,9,9,9,9,6,6,6,6,6,6,9,9,9,9,9,9,9,9,9,9,9,9,9
1,1,9,9,9,9,9,9,9,9,9,9,9,9,9,9,9,9,9,9,6,6,6,6,6,6,6,9,9,9,9,9,9,9,9,9,9,9,9,9
1,1,9,9,9,9,9,9,9,9,9,9,9,9,9,9,9,9,9,9,6,6,6,6,6,6,6,9,9,9,9,9,9,9,9,9,9,9,9,9
1,1,9,9,9,9,9,9,9,9,9,9,9,9,9,9,9,9,9,9,6,6,6,6,6,6,6,9,9,9,9,9,9,9,9,9,9,9,9,9
1,1,9,9,9,9,9,9,9,9,9,9,9,9,9,9,9,9,9,9,9,6,6,6,6,6,6,9,9,9,9,9,9,9,9,9,9,9,9,9
1,1,9,9,9,9,9,9,9,9,9,9,9,9,9,9,9,9,9,9,9,6,6,6,6,6,6,9,9,9,9,9,9,9,9,9,9,9,9,9
1,1,9,9,9,9,9,9,9,9,9,9,9,9,9,9,9,9,9,9,9,6,6,6,6,6,9,9,9,9,9,9,9,9,9,9,9,9,9,9
1,9,9,9,9,9,9,9,9,9,9,9,9,9,9,9,9,9,9,9,9,6,6,6,6,9,9,9,9,9,9,9,9,9,9,9,9,9,9,9
1,9,9,9,9,9,9,9,9,9,9,9,9,9,9,9,9,9,9,9,9,6,6,6,6,6,9,9,9,9,9,9,9,9,9,9,9,9,9,9
1,9,9,9,9,9,9,9,9,9,9,9,9,9,9,9,9,9,9,9,9,6,6,6,6,6,6,6,6,6,6,6,9,9,9,9,9,9,9,9
1,9,9,9,9,9,9,9,9,9,9,9,9,9,9,9,9,9,9,9,9,6,6,6,6,6,6,6,6,6,6,6,6,9,9,9,9,9,9,9
1,9,9,9,9,9,9,9,9,9,9,9,9,9,9,9,9,9,9,9,9,6,6,6,6,6,6,6,6,6,6,6,6,6,9,9,9,9,9,9
1,9,9,9,9,9,9,9,9,9,9,9,9,9,9,9,9,9,9,9,9,6,6,6,6,6,6,6,6,6,6,6,6,6,9,9,9,9,9,9
1,9,9,9,9,9,9,9,9,9,9,9,9,9,9,9,9,9,9,9,9,9,6,6,6,6,6,6,6,6,6,6,6,6,6,9,9,9,9,9
1,9,9,9,9,9,9,9,9,9,9,9,9,9,9,9,9,9,9,9,9,9,6,6,6,6,6,6,6,6,6,6,6,6,6,9,9,9,9,9
1,9,9,9,9,9,9,9,9,9,9,9,9,9,9,9,9,9,9,9,9,9,9,6,6,6,6,6,6,6,6,6,6,6,6,6,9,9,9,9
1,9,9,9,9,9,9,9,9,9,9,9,9,9,9,9,9,9,9,9,9,9,9,9,6,6,6,6,6,6,6,6,6,6,6,6,6,9,9,9
1,9,9,9,9,9,9,9,9,9,9,9,9,9,9,9,9,9,9,9,9,9,9,9,9,9,6,6,9,9,9,6,6,6,6,6,6,6,9,9
1,9,9,9,9,9,9,9,9,9,9,9,9,9,9,9,9,9,9,9,9,9,9,9,9,9,9,9,9,9,9,6,6,6,6,6,6,6,9,9
1,9,9,9,9,9,9,9,9,9,9,9,9,9,9,9,9,9,9,9,9,9,9,9,9,9,9,9,9,9,9,9,6,6,6,6,6,6,9,9
1,9,9,9,9,9,9,9,9,9,9,9,9,9,9,9,9,9,9,9,9,9,9,9,9,9,9,9,9,9,9,9,9,6,6,6,6,6,6,9
1,9,9,9,9,9,9,9,9,9,9,9,9,9,9,9,9,6,6,9,9,9,9,9,9,9,9,9,9,9,9,9,9,9,6,6,6,6,6,9