2,2,2,2,2,2,2,2,2,2,2,2,5,2,2,5,2,2,2,2,2,2,2,2,2,2,2,2,5,5,2,2,2,2,2,2,2,2,2,5
2,2,2,2,2,2,2,2,2,2,2,2,5,2,2,2,5,2,2,2,2,2,2,2,2,5,5,5,2,2,2,2,2,2,2,2,2,2,2,5
2,2,2,2,2,2,2,2,2,2,2,2,5,2,2,2,5,2,2,2,2,2,2,5,5,2,2,2,2,2,2,2,2,2,2,2,2,2,2,5
2,2,2,2,2,2,2,2,2,2,2,2,5,2,2,2,5,2,2,2,2,5,5,2,2,2,2,2,2,2,2,2,2,2,2,2,2,2,5,2
2,2,2,2,2,2,2,2,2,2,2,2,5,2,2,2,5,2,2,9,9,9,2,2,2,2,2,2,2,2,2,2,2,2,2,2,2,2,5,2
2,2,2,2,2,2,2,2,2,2,2,2,5,2,2,2,5,2,5,2,2,2,2,2,2,2,2,2,2,2,2,2,2,2,2,2,2,5,2,2
2,2,2,2,2,2,2,2,2,2,2,2,5,2,2,2,5,5,2,2,2,2,2,2,2,2,2,2,2,2,2,2,2,2,2,2,5,2,2,2
2,2,2,2,2,2,2,2,2,2,2,2,5,2,2,5,5,2,2,2,2,2,2,2,2,2,2,2,2,2,2,2,2,2,2,5,2,2,2,2
2,2,2,2,2,2,2,2,2,2,2,2,5,5,5,2,5,2,2,2,2,2,2,2,2,2,2,2,2,2,2,2,2,2,5,2,2,2,2,2
2,2,2,2,2,2,2,2,2,2,2,2,5,2,2,2,2,5,2,2,2,2,2,2,2,2,2,2,2,2,2,2,2,5,2,2,2,2,2,2
2,2,2,2,2,2,2,2,2,2,2,5,5,2,2,2,2,5,2,2,2,2,2,2,2,2,2,2,2,2,2,2,5,2,2,2,2,2,2,2
2,2,2,2,2,2,2,2,2,5,5,2,5,2,2,2,2,5,2,2,2,2,2,2,2,2,2,2,2,2,2,5,2,2,2,2,2,2,2,2
2,2,2,2,2,2,2,2,5,2,2,2,5,2,2,2,2,5,2,2,2,2,2,2,2,2,2,2,2,2,5,2,2,2,2,2,2,2,2,2
2,2,2,2,2,2,2,5,5,5,5,5,5,5,5,5,5,5,5,5,5,5,5,5,5,5,5,5,5,5,5,5,5,5,5,5,5,5,5,5
2,2,2,2,2,2,2,2,2,2,2,2,5,2,2,2,2,5,2,2,2,2,2,2,2,2,2,2,5,2,2,2,2,2,2,2,2,2,2,5
2,2,2,2,2,2,2,2,2,2,2,2,5,2,2,2,2,5,2,2,2,2,2,2,2,2,2,2,5,2,2,2,2,2,2,2,2,2,5,2
2,2,2,2,2,2,2,2,2,2,2,2,5,2,2,2,2,5,2,2,2,2,2,5,2,2,2,5,2,2,2,2,2,2,2,2,5,5,2,2
2,2,2,2,2,2,2,2,2,2,2,2,5,2,2,2,2,5,2,2,2,2,2,5,2,2,5,2,2,2,2,2,2,2,5,5,2,2,2,2
2,2,2,2,2,2,2,2,2,2,2,2,5,2,2,2,2,5,2,2,2,2,2,5,2,5,2,2,2,2,2,2,2,5,2,2,2,2,2,2
2,2,2,2,2,2,2,2,2,2,2,2,5,2,2,2,2,5,2,2,2,2,2,5,5,2,2,2,2,2,2,2,5,2,2,2,2,2,2,2
2,2,2,2,2,2,2,2,2,2,2,2,5,2,2,2,2,5,2,2,2,2,2,5,2,2,2,2,2,2,2,5,2,2,2,2,2,2,2,2
2,2,2,2,2,2,2,2,2,2,2,2,5,2,2,2,2,5,2,2,2,2,5,5,2,2,2,2,2,2,5,2,2,2,2,2,2,2,2,2
2,2,2,2,2,2,2,2,2,2,2,2,5,2,2,2,2,5,2,2,2,5,2,5,2,2,2,2,2,5,2,2,2,2,2,2,2,2,2,2
2,2,2,2,2,2,2,2,2,2,2,2,5,2,2,2,2,5,2,2,5,2,2,5,2,2,2,2,5,2,2,2,2,2,2,2,2,2,2,2
2,2,2,2,2,2,2,2,2,2,2,2,5,2,2,2,2,5,2,5,2,2,2,5,2,2,2,5,2,2,2,2,2,2,2,2,2,2,2,2
2,2,2,2,2,2,2,2,2,2,2,2,5,2,2,2,2,5,5,2,2,2,2,5,2,2,5,2,2,2,2,2,2,2,2,2,2,2,2,2
2,2,2,2,2,2,2,2,2,2,2,2,5,2,2,2,2,5,5,2,2,2,2,5,2,5,2,2,2,2,2,2,2,2,2,2,2,2,2,2
2,2,2,2,2,2,2,2,2,2,2,2,5,2,2,2,5,2,5,2,2,2,5,2,5,2,2,2,2,2,2,2,2,2,2,2,2,2,2,2
2,2,2,2,2,2,2,2,2,2,2,2,5,2,5,5,2,2,5,2,2,2,5,5,2,2,2,2,2,2,2,2,2,2,2,2,2,2,2,2
2,2,2,2,2,2,2,2,2,2,2,2,5,5,2,2,2,2,5,2,2,5,5,2,2,2,2,2,2,2,2,2,2,2,2,2,2,2,2,2
2,2,2,2,2,2,2,2,2,2,2,2,5,2,2,2,2,2,5,2,2,5,5,2,2,2,2,2,2,2,2,2,2,2,2,2,2,2,2,2
2,2,2,2,2,2,2,2,2,2,5,5,5,2,2,2,2,2,5,2,2,5,2,2,2,2,2,2,2,2,2,2,2,2,2,2,2,2,2,2
2,2,2,2,2,2,2,2,2,5,2,2,5,2,2,2,2,2,5,2,5,5,2,2,2,2,2,2,2,2,2,2,2,2,2,2,2,2,2,2
2,2,2,2,2,2,2,2,5,2,2,2,5,2,2,2,2,2,5,2,5,5,2,2,2,2,2,2,2,2,2,2,2,2,2,2,2,2,2,2
2,2,2,2,2,2,5,5,2,2,2,2,5,2,2,2,2,2,5,5,5,2,2,2,2,2,2,2,2,2,2,2,2,2,2,2,2,2,2,2
2,2,2,2,2,5,2,2,2,2,2,2,5,2,2,2,2,2,5,5,2,2,2,2,2,2,2,2,2,2,2,2,2,2,2,2,2,2,2,2
2,2,2,5,5,2,2,2,2,2,2,2,5,2,2,2,2,2,5,5,2,2,2,2,2,2,2,2,2,2,2,2,2,2,2,2,2,2,2,2
2,5,5,2,2,2,2,2,2,2,2,2,5,2,2,2,2,5,5,2,2,2,2,2,2,2,2,2,2,2,2,2,2,2,2,2,2,2,2,2
5,2,2,2,2,2,2,2,2,2,2,2,5,2,2,2,2,5,5,2,2,2,2,2,2,2,2,2,2,2,2,2,2,2,2,2,2,2,2,2
2,2,2,2,2,2,2,2,2,2,2,2,5,2,2,5,5,5,5,2,2,2,2,2,2,2,2,2,2,2,2,2,2,2,2,2,2,2,2,2