16,16,16,16,13,13,13,13,13,13,13,13,13,13,13,13,13,13,13,13,13,13,14,14,14,15,14,14,14,13,13,13,13,13,13,13,16,16,16,16,16,16,16,16,16,16,16,16,16,16
16,16,16,16,16,13,13,13,13,13,13,13,13,13,13,13,13,13,13,13,13,13,14,14,14,15,14,14,14,13,13,13,13,13,13,13,16,16,16,16,16,16,16,16,16,16,16,16,16,16
16,16,16,16,16,13,13,13,13,13,13,13,13,13,13,13,13,13,13,13,13,13,14,14,14,15,14,14,14,13,13,13,13,13,13,13,16,16,16,16,16,16,16,16,16,16,16,16,16,16
16,16,16,16,16,16,13,13,13,13,13,13,13,13,13,13,13,13,13,13,13,13,14,14,14,15,14,14,14,13,13,13,13,13,13,13,16,16,16,16,16,16,16,16,16,16,16,16,16,16
16,16,16,16,16,16,16,13,13,13,13,13,13,13,13,13,13,13,13,13,13,13,14,14,14,15,14,14,14,13,13,13,13,13,13,13,16,16,16,16,16,16,16,16,16,16,16,16,16,16
16,16,16,16,16,16,16,16,13,13,13,13,13,13,13,13,13,13,13,13,13,13,14,14,14,15,14,14,14,13,13,13,13,13,13,13,16,16,16,16,16,16,16,16,16,16,16,16,16,16
16,16,16,16,16,16,16,16,13,13,13,13,13,13,13,13,13,13,13,13,13,13,14,14,14,15,14,14,14,13,13,13,13,13,13,13,16,16,16,16,16,16,16,16,16,16,16,16,16,16
16,16,16,16,16,16,16,16,13,13,13,13,13,13,13,13,13,13,13,13,13,13,14,14,14,15,14,14,14,13,13,13,13,13,13,13,16,16,16,16,16,16,16,16,16,16,16,16,16,16
16,16,16,16,16,16,16,16,13,13,13,13,13,13,13,13,13,13,13,13,13,13,14,14,14,15,14,14,14,13,13,13,13,13,13,13,13,16,16,16,16,16,16,16,16,16,16,16,16,16
16,16,16,16,16,16,16,16,13,13,13,13,13,13,13,13,13,13,13,13,13,13,14,14,14,15,14,14,14,13,13,13,13,13,13,13,13,16,16,16,16,16,16,16,16,16,16,16,16,16
16,16,16,16,16,16,16,16,13,13,13,13,13,13,13,13,13,13,13,13,13,13,14,14,14,15,14,14,14,13,13,13,13,13,13,13,13,16,16,16,16,16,16,16,16,16,16,16,16,16
16,16,16,16,16,16,16,16,13,13,13,13,13,13,13,13,13,13,13,13,13,13,14,14,14,15,14,14,14,13,13,13,13,13,13,13,13,16,16,16,16,16,16,16,16,16,16,16,16,16
16,16,16,16,16,16,16,16,13,13,13,13,13,13,13,13,13,13,13,13,13,13,14,14,14,15,14,14,14,13,13,13,13,13,13,13,13,16,16,16,16,16,16,16,16,16,16,16,16,16
16,16,16,16,16,16,16,16,13,13,13,13,13,13,13,13,13,13,13,13,13,13,14,14,14,15,14,14,14,13,13,13,13,13,13,13,13,16,16,16,16,16,16,16,16,16,16,16,16,16
16,16,16,16,16,16,16,16,13,13,13,13,13,13,13,13,13,13,13,13,13,13,14,14,14,15,14,14,14,13,13,13,13,13,13,13,13,13,16,16,16,16,16,16,16,16,16,16,16,16
16,16,16,16,16,16,16,16,13,13,13,13,13,13,13,13,13,13,13,13,13,13,14,14,14,15,14,14,14,13,13,13,13,13,13,13,13,13,16,16,16,16,16,16,16,16,16,16,16,16
16,16,16,16,16,16,16,16,13,13,13,13,13,13,13,13,13,13,13,13,13,13,14,14,14,15,14,14,14,13,13,13,13,13,13,13,13,13,16,16,16,16,16,16,16,16,16,16,16,16
16,16,16,16,16,16,16,16,13,13,13,13,13,13,13,13,13,13,13,13,13,13,14,14,14,15,14,14,14,13,13,13,13,13,13,13,13,13,16,16,16,16,16,16,16,16,16,16,16,16
16,16,16,16,16,16,16,16,13,13,13,13,13,13,13,13,13,13,13,13,13,13,14,14,14,15,14,14,14,13,13,13,13,13,13,13,13,13,16,16,16,16,16,16,16,16,16,16,16,16
16,16,16,16,16,16,16,16,13,13,13,13,13,13,13,13,13,13,13,13,13,13,14,14,14,15,14,14,14,13,13,13,13,13,13,13,13,16,16,16,16,16,16,16,16,16,16,16,16,16
16,16,16,16,16,16,16,16,13,13,13,13,13,13,13,13,13,13,13,13,13,13,14,14,14,15,14,14,14,13,13,13,13,13,13,13,13,16,16,16,16,16,16,16,16,16,16,16,16,16
16,16,16,16,16,16,16,16,13,13,13,13,13,13,13,13,13,13,13,13,13,13,14,14,14,15,14,14,14,13,13,13,13,13,13,13,13,16,16,16,16,16,16,16,16,16,16,16,16,16
16,16,16,16,16,16,16,16,13,13,13,13,13,13,13,13,13,13,13,13,13,13,14,14,14,15,14,14,14,13,13,13,13,13,13,13,13,16,16,16,16,16,16,16,16,16,16,16,16,16
16,16,16,16,16,16,16,16,13,13,13,13,13,13,13,13,13,13,13,13,13,13,14,14,14,15,14,14,14,13,13,13,13,13,13,13,16,16,16,16,16,16,16,16,16,16,16,16,16,16
16,16,16,16,16,16,16,16,16,13,13,13,13,13,13,13,13,13,13,13,13,13,14,14,14,15,14,14,14,13,13,13,13,13,13,13,16,16,16,16,16,16,16,16,16,16,16,16,16,16
16,16,16,16,16,16,16,16,16,13,13,13,13,13,13,13,13,13,13,13,13,13,14,14,14,15,14,14,14,13,13,13,13,13,13,13,16,16,16,16,16,16,16,16,16,16,16,16,16,16
16,16,16,16,16,16,16,16,16,13,13,13,13,13,13,13,13,13,13,13,13,13,14,14,14,15,14,14,14,13,13,13,13,13,13,13,16,16,16,16,16,16,16,16,16,16,16,16,16,16
16,16,16,16,16,16,16,16,16,13,13,13,13,13,13,13,13,13,13,13,13,13,14,14,14,15,14,14,14,13,13,13,13,13,13,13,16,16,16,16,16,16,16,16,16,16,16,16,16,16
16,16,16,16,16,16,16,16,16,13,13,13,13,13,13,13,13,13,13,13,13,13,14,14,14,15,14,14,14,13,13,13,13,13,13,13,16,16,16,16,16,16,16,16,16,16,16,16,16,16
16,16,16,16,16,16,16,16,13,13,13,13,13,13,13,13,13,13,13,13,13,13,14,14,14,15,14,14,14,13,13,13,13,13,13,13,16,16,16,16,16,16,16,16,16,16,16,16,16,16
16,16,16,16,16,16,16,13,13,13,13,13,13,13,13,13,13,13,13,13,13,13,14,14,14,15,14,14,14,13,13,13,13,13,13,13,16,16,16,16,16,16,16,16,16,16,16,16,16,16
16,16,16,16,16,16,13,13,13,13,13,13,13,13,13,13,13,13,13,13,13,13,14,14,14,15,14,14,14,13,13,13,13,13,13,13,13,16,16,16,16,16,16,16,16,16,16,16,16,16
16,16,16,16,16,13,13,13,13,13,13,13,13,13,13,13,13,13,13,13,13,13,14,14,14,15,14,14,14,13,13,13,13,13,13,13,13,16,16,16,16,16,16,16,16,16,16,16,16,16
16,16,16,16,16,13,13,13,13,13,13,13,13,13,13,13,13,13,13,13,13,13,14,14,14,15,14,14,14,13,13,13,13,13,13,13,13,16,16,16,16,16,16,16,16,16,16,16,16,16
16,16,16,16,13,13,13,13,13,13,13,13,13,13,13,13,13,13,13,13,13,13,14,14,14,15,14,14,14,13,13,13,13,13,13,13,13,16,16,16,16,16,16,16,16,16,16,16,16,16
16,16,16,16,13,13,13,13,13,13,13,13,13,13,13,13,13,13,13,13,13,13,14,14,14,15,14,14,14,13,13,13,13,13,13,13,13,16,16,16,16,16,16,16,16,16,16,16,16,16
16,16,16,16,13,13,13,13,13,13,13,13,13,13,13,13,13,13,13,13,13,13,14,14,14,15,14,14,14,13,13,13,13,13,13,13,13,16,16,16,16,16,16,16,16,16,16,16,16,16
16,16,16,13,13,13,13,13,13,13,13,13,13,13,13,13,13,13,13,13,13,13,14,14,14,15,14,14,14,13,13,13,13,13,13,13,13,13,16,16,16,16,16,16,16,16,16,16,16,16
16,16,16,13,13,13,13,13,13,13,13,13,13,13,13,13,13,13,13,13,13,13,14,14,14,15,14,14,14,13,13,13,13,13,13,13,13,13,16,16,16,16,16,16,16,16,16,16,16,16
16,16,16,13,13,13,13,13,13,13,13,13,13,13,13,13,13,13,13,13,13,13,14,14,14,15,14,14,14,13,13,13,13,13,13,13,13,13,13,13,16,16,16,16,16,16,16,16,16,16